###################################
#.....|...........|.....#.,,,,,,,,#
#.....|...........|.....#.,.......#
#.....\___________/.....#.,.#######
#.......................#.,.#.....#
##.....................##.,,-.....#
 ##...................###.,.#.....#
  ##.................## #.,.#######
   ##...............##  #.,.#.....#
    ##.............##   #.,,-.....#
     ######---###########.,.#.....#
          #.,.#.\_____/.#.,.#######
          #.,.#.........#.,.#.....#
          #.,.#.........#.,,-.....#
          #.,.#.........#.,.#.....#
    #######.,.####---####---#######
    #.......,......,......,.......#
#####.......,......,......,.......#
>,,,,,,,,,,,,,,,,,,,,,,,,,,.......#
#####.............................#
    ###############################