############################
#....|.......|......-......#
#....|.......|......-......#
#....|.......|....######.,.#######
#....\_______/....#....#.,.#.....#
#.................#....-,,,-.....#
#.................#....#.,.#.....#
##...............#######.,.#######
 ##.............##     #.,.#.....#
  ##............#      #.,,-.....#
   #####---########### #.,.#.....#
       #.,.#.\_____/.# #.,.#######
       #.,.#.........# #.,.#.....#
       #.,.#.........# #.,,-.....#
       #.,.#.........# #.,.#.....#
  ######.,.####---######---#######
  #......,......,........,.#
  #......,......,........,.#
  >,,,,,,,,,,,,,,,,,,,,,,,.#
  #........................#
  ##########################
