############################
#....|.........|....-......#
#....|.........|....-......#
#....|.........|....####.,.#######
#....\_________/....#  #.,.#.....#
#...................#  #.,,-.....#
#...................#  #.,.#.....#
##.................##  #.,.#######
 ##...............##   #.,.#.....#
  ##.............##    #.,,-.....#
   #####---########### #.,.#.....#
       #.,.#.\_____/.# #.,.#######
       #.,.#.........# #.,.#.....#
       #.,.#.........# #.,,-.....#
       #.,.#.........# #.,.#.....#
  ######.,.####---######---#######
  #.......,......,.......,.#
  #.......,......,.......,.#
  >,,,,,,,,,,,,,,,,,,,,,,,.#
  #........................#
  ##########################
